R 1280 720

NO ./textures/north
SO ./textures/south
WE ./textures/west
EA ./textures/east

S ./sprites

F 220,100,0
C 225,30,0

 11111111111111111
 10001000010010001
 11000200111000001
 10000111100011111
 1001101111101
11101101000001
10000002000011
102000N000001
1111111111111